
Status Tab

  Status: Status

  Show: Show
  Audio Stream: Audio Stream
  Visual Stream: Visual Stream

  Current Time: Current Time
  Uptime: Uptime
  Show Type: Show Type
  Show ID: Show ID
  Show Name: Show Name
  Show Description: Show Description
  Last Updated: Last Update

  Media Type: Media Type
  Order #: Order #
  Media ID: Media ID
  Media Artist: Media Artist
  Media Title: Media Title
  Media Duration: Media Duration
  Scheduled End: Scheduled End

  Logs: Logs
  Log Level: Log Level
  Normal: Normal
  Debug: Debug
  Downloads: Downloads

Status Media Type

  audio: audio
  video: video
  image: image

Status Show Type

  standard: standard
  advanced: advanced
  liveassist: liveassist

Logs Download:

  Status Logs: Status Logs
  Audio Logs: Audio Logs

